WWWWWWWWWWWWWWWWWWWWWWWWWWWWW
W0..........................W
W...........................W
W...........................W
W.........W.......W.........W
W...........................W
W.....W........P......W.....W
W......WW...........WW......W
W........WWWWWWWWWWW........W
W...........................W
W.....E.....................W
W....................E......W
W...........................W
W...............E...........W
W...........................W
W....E......................W
W...........................W
W...........................W
W...............E...........W
W...........................W
W...........................W
W...................E.......W
W...........................W
W...........................W
W...........................W
W...........................W
W...........................W
W...........................W
W..........................0W
WWWWWWWWWWWWWWWWWWWWWWWWWWWWW
