WWWWWWWWWW
W0.......W
W........W
W........W
W....P...W
W........W
W...E....W
W........W
W.......0W
WWWW..WWWW
...W..W...
...W..W...
WWWW..WWWW
W1.......W
W........W
W........W
W....E...W
W........W
W........W
W...T....W
W.......1W
WWWWWWWWWW
