0WWWWWWWWWWWWWWW..
.W.............W..
.W.............W.1WWWWWWWWWWWWWWWW
.W.............W..W..............W
.W....P........W..W......E.......W
.W.............W..W..............W
.W.............WWWW..............W
.W.......E......D................W
.W..............D.....L......E...W
.W.............WWWW..............W
.W.............W..W..............WWWWWWWWWWWWWWWWW
.W........F....W..W..............................W
.W...L.........W..W.............F................W
.W.............W..W......E................E......W
.WWWWWWWWWWWWWWW0.W..............................W
..................WWWWWWWWWWWWWWWWWWWWWWWWWWW..WWW
............................................WDDW..
............................................W..W.1
.WWWWWWWWWWWWWWWWWWWWWWWWWWWWWWWWWWWWWWWWWWWW..WWW
.W2..............................................W
.W.....E.........................................W
.W......................E........................W
.W...............................................W
.W...............................................W
.W...........E.........................E.........W
.W...............................................W
.W...............................................W
.W.....E................E........................W
.W...............O...............................W
.W..............................................2W
.WWWWWWWWWWWWWWWWWWWWWWWWWWWWWWWWWWWWWWWWWWWWWWWWW